개밥	ncn
갈비탕	ncn
관형격	ncn
교착어	ncn
그분들	npp
극진	ncps
당신들	npp
동량재	ncn
서충원	ncn
우체통	ncn
의미	ncpa
이신목	nqpc
자동사	ncn
불고기덮밥	ncn
춘천닭갈비	ncn
부대찌개	ncn
해물파전	ncn
해물찜	ncn
신선로	ncn
화양적	ncn
궁중떡볶이	ncn
안좋	ncn
좋지않	ncn
·	sy